. . . . . . . . t t t t t . . . . . . . . .
. . . . . . . . . . . . . . . . . . . . . .
. . . . . . . . . . . . . . . . . . . . . .
. . . . . . . . . . . . . . . . . . . . . .
t t t t t t t . . . t t t t t t t t t t t t
b b b b b b b . . . b b b b b b b b b b b b
b b b b b b b . . . b b b b b b b b b b b b
